NO ./path_to_the_north_texture
EA ./path_to_the_east_texture
SO ./path_to_the_north_texture
WE ./path_to_the_west_texture

C 0,0,255
F 0,255,0

11111111111111111111111111111111111111
10000000000000000000000000000000000001
10000000000000000000000000000000000001
10000000000000000000000000000000000001
10000000000000000000000000000000000001
10000000000000000000000000000000000001
10000000000000001000000000000000000001
1000000000000000D000000000000000000001
10000000000000001100000000000000000001
10000000000000001000000000000000000001
10000000000000000000000000000000000001
10000000000000000000000000000000000001
10000000000000000000000000000000000001
10000000000000000N00000000000000000001
10000000000000000000000000000000000001
10000000000000000000000000000000000001
11111111111111111111111111111111111111
