NO ./textures/test.xpm
EA ./textures/test.xpm
SO ./textures/test.xpm
WE ./textures/test.xpm

C 80,80,80
F 255,00,00

1111111111111111111
1000100010001000101
1D10101010101010101
1D10101010101010101
1D10101010101010101
1D10101010101010101
1D10101010101010101
1D10101010101010101
1D10101010101010101
1D10101010101010101
1010101010101010101
1N10001000100010001
1111111111111111111
