NO ./textures/test.xpm
EA ./textures/test.xpm
SO ./textures/test.xpm
WE ./textures/test.xpm

C 80,80,80
F 255,00,00

1111111111111111111
1DDD100010001000101
1D1D101010101010101
1D1D101010101010101
1D1D101010101010101
1D1D101010101010101
1D1D101010101010101
1D1D101010101010101
1D1D101010101010101
1D1D101010101010101
101D101010101010101
1N10001000100010001
1111111111111111111
