NO ./textures/test.xpm

EA ./textures/test.xpm
SO ./textures/test.xpm
WE ./textures/test.xpm
DO ./textures/door.xpm

F 255,0,0
C 0,0,255

 111111111101111111111111
1D00000000110000000000001
1011000001 10000000000001
100100000010000000000000111111111
1D1111111011000001110000000000001
100000000011100001111111110111111
1111D111111 11101110000001011
1111D111111 11011101010010001
11000000110101011100000010001
1000E0000000000000000000011DD1
10000000000000001101000010001
11000001110101011111000000111
11110111 1110101 100000000001
11111111 1111111 111111111111
