NO ./textures/zombie.xpm
EA ./textures/wall1.xpm
SO ./textures/wall2.xpm
WE ./textures/jhauvill.xpm
DO ./textures/door.xpm

C 255,84,0
F 98,83,64

11111111111111111111111111111111111
10001000001000000000000010001000001
11101110101011101011111010101011101
10001000101010101010001000101010001
10111011111010101110101111101010111
10100010000010100000100000101010001
10101110111110111111111110111011101
10100000100000000000100010001000101
10101111111111101010111011101110101
10100010001000101010000000100010101
10111010101010111011111111101010101
10100010100010100010000010001010101
10101110111110101010111010111110101
10100010100010001010101010000000101
10111010101011111110101010111110101
10100000101000001000100010100010101
10111110101111101011101110101011101
10001000101000000010101000101000101
11101111101111111110101111101110101
10001000001000000010100000100010101
10111011111011111010111110111010101
10100000000000001010000010001010101
1011111111D111111010101111101010101
100000000000000000101000000000D00N1
11111111111111111111111111111111111