NO ./textures/test.xpm
EA ./textures/test.xpm
SO ./textures/test.xpm
WE ./textures/test.xpm
DO ./textures/door.xpm

C 0,100,255
F 60,60,60

            11111111111111111111111111111111111111111111111111111111
            1110000000000000000000000000000000000000000000000010011
              1000000000000000000000000000000000000000000000001
              1000000000000000000000000000000000000000000000001
              1000000000000000111000000000000000000000000000001
              10000000000000001  10000000000000000000000000000111
              10000000000000001111000DDD0000000000000000000000001
         1111111000000000000000000000DND0000000000000000000000111
         1000000000000000000000000000DDD00000000000000000000001
         100000000000000000000000000000000000000000000000000001
         100000000000000000000000000000000000000000000000000001
         100000000000000000000000000000000000000000000000000001
         100000000000000000000000000000000000000000000000000001111111111111
         11111111111111111111111111111111111111111111111111111111111111111111111111111
