NO ./textures/test.xpm
EA ./textures/test.xpm
SO ./textures/test.xpm
WE ./textures/test.xpm

C 0,100,255
F 60,60,60

            11111111111111111111111111111111111111111111111111111111
            11100000000000000000000000000000000000000000000000111111
              1000000000000000000000000000000000000000000000001
              1000000000000000000000000000000000000000000000001
              1000000000000000000000000000000000000000000000001
              1000000000000000000000000000000000000000000000001
              1000000000000000000000000000000000000000000000001
         11111110000000000000000000000N000000000000000000000001
         100000000000000000000000000000000000000000000000000001
         100000000000000000000000000000000000000000000000000001
         100000000000000000000000000000000000000000000000000001
         100000000000000000000000000000000000000000000000000001
         100000000000000000000000000000000000000000000000000001111111111111
         11111111111111111111111111111111111111111111111111111111111111111111111111111
