NO ./textures/zombie.xpm
EA ./textures/wall1.xpm
SO ./textures/wall2.xpm
WE ./textures/jhauvill.xpm
DO ./textures/door.xpm

C 255,84,0
F 98,83,64

11111111111111111111111111111111111111111111111111111111111111111111111111111111111111111111111111111111111111111111111111
10101010000010100000101000001010000010100000101000001010000010100000101000001010000010100000101000001010000010100000101001
10101010111110101111101011111010111110101111101011111010111110101111101011111010111110101111101011111010111110101111101011
10101010100000101000001010000010100000101000001010000010100000101000001010000010100000101000001010000010100000101000001011
10101010101111101011111010111110101111101011111010111110101111101011111010111110101111101011111010111110101111101011111011
10101010101000001010000010100000101000001010000010100000101000001010000010100000101000001010000010100000101000001010000011
10101010101011111010111110101111101011111010111110101111101011111010111110101111101011111010111110101111101011111010111111
10101010101010000010100000101000001010000010100000101000001010000010100000101000001010000010100000101000001010000010100001
10101010101010111110101111101011111010111110101111101011111010111110101111101011111010111110101111101011111010111110101111
10101010101010100000101000001010000010100000101000001010000010100000101000001010000010100000101000001010000010100000101001
10101010101010101111101011111010111110101111101011111010111110101111101011111010111110101111101011111010111110101111101011
10101010101010101000001010000010100000101000001010000010100000101000001010000010100000101000001010000010100000101000001011
10101010101010101011111010111110101111101011111010111110101111101011111010111110101111101011111010111110101111101011111011
10101010101010101010000010100000101000001010000010100000101000001010000010100000101000001010000010100000101000001010000011
10101010101010101010111110101111101011111010111110101111101011111010111110101111101011111010111110101111101011111010111111
10101010101010101010100000101000001010000010100000101000001010000010100000101000001010000010100000101000001010000010100001
10101010101010101010101111101011111010111110101111101011111010111110101111101011111010111110101111101011111010111110101111
10101010101010101010101000001010000010100000101000001010000010100000101000001010000010100000101000001010000010100000101001
10101010101010101010101011111010111110101111101011111010111110101111101011111010111110101111101011111010111110101111101011
10101010101010101010101010000010100000101000001010000010100000101000001010000010100000101000001010000010100000101000001011
1010101010101010101010101011111010111110101111101011111N101111101011111010111110101111101011111010111110101111101011111011
10101010101010101010101010100000101000001010000010100000101000001010000010100000101000001010000010100000101000001010000011
10101010101010101010101010101111101011111010111110101111101011111010111110101111101011111010111110101111101011111010111111
10101010101010101010101010101000001010000010100000101000001010000010100000101000001010000010100000101000001010000010100001
10101010101010101010101010101011111010111110101111101011111010111110101111101011111010111110101111101011111010111110101111
10101010101010101010101010101010000010100000101000001010000010100000101000001010000010100000101000001010000010100000101001
10101010101010101010101010101010111110101111101011111010111110101111101011111010111110101111101011111010111110101111101011
10101010101010101010101010101010100000101000001010000010100000101000001010000010100000101000001010000010100000101000001011
10101010101010101010101010101010101111101011111010111110101111101011111010111110101111101011111010111110101111101011111011
10101010101010101010101010101010101000001010000010100000101000001010000010100000101000001010000010100000101000001010000011
10101010101010101010101010101010101011111010111110101111101011111010111110101111101011111010111110101111101011111010111111
10101010101010101010101010101010101010000010100000101000001010000010100000101000001010000010100000101000001010000010100001
10101010101010101010101010101010101010111110101111101011111010111110101111101011111010111110101111101011111010111110101111
10101010101010101010101010101010101010100000101000001010000010100000101000001010000010100000101000001010000010100000101001
10101010101010101010101010101010101010101111101011111010111110101111101011111010111110101111101011111010111110101111101011
10101010101010101010101010101010101010101000001010000010100000101000001010000010100000101000001010000010100000101000001011
10101010101010101010101010101010101010101011111010111110101111101011111010111110101111101011111010111110101111101011111011
10101010101010101010101010101010101010101010000010100000101000001010000010100000101000001010000010100000101000001010000011
10101010101010101010101010101010101010101010111110101111101011111010111110101111101011111010111110101111101011111010111111
10101010101010101010101010101010101010101010100000101000001010000010100000101000001010000010100000101000001010000010100001
10101010101010101010101010101010101010101010101111101011111010111110101111101011111010111110101111101011111010111110101111
10101010101010101010101010101010101010101010101000001010000010100000101000001010000010100000101000001010000010100000101001
10101010101010101010101010101010101010101010101011111010111110101111101011111010111110101111101011111010111110101111101011
10101010101010101010101010101010101010101010101010000010100000101000001010000010100000101000001010000010100000101000001011
10101010101010101010101010101010101010101010101010111110101111101011111010111110101111101011111010111110101111101011111011
10101010101010101010101010101010101010101010101010100000101000001010000010100000101000001010000010100000101000001010000011
10101010101010101010101010101010101010101010101010101111101011111010111110101111101011111010111110101111101011111010111111
10101010101010101010101010101010101010101010101010101000001010000010100000101000001010000010100000101000001010000010100001
10101010101010101010101010101010101010101010101010101011111010111110101111101011111010111110101111101011111010111110101111
10101010101010101010101010101010101010101010101010101010000010100000101000001010000010100000101000001010000010100000101001
10101010101010101010101010101010101010101010101010101010111110101111101011111010111110101111101011111010111110101111101011
10101010101010101010101010101010101010101010101010101010100000101000001010000010100000101000001010000010100000101000001011
10101010101010101010101010101010101010101010101010101010101111101011111010111110101111101011111010111110101111101011111011
10101010101010101010101010101010101010101010101010101010101000001010000010100000101000001010000010100000101000001010000011
10101010101010101010101010101010101010101010101010101010101011111010111110101111101011111010111110101111101011111010111111
10101010101010101010101010101010101010101010101010101010101010000010100000101000001010000010100000101000001010000010100001
11111111111111111111111111111111111111111111111111111111111111111111111111111111111111111111111111111111111111111111111111
