NO ./path_to_the_north_texture
EA ./path_to_the_east_texture
SO ./path_to_the_south_texture
WE ./path_to_the_west_texture

F 220,100,0
C 255,255,255

11111
10001
10N01
11111
