NO ./path_to_the_north_texture
EA ./path_to_the_east_texture
SO ./path_to_the_south_texture
WE ./path_to_the_west_texture

C 0,100,255
F 60,60,60

1111111111111111111111111111111111111111111111111111111111111111111111111111111111111111111111111111111
1000000000000000000000000000000000000000000000000000000000000000000000000000000000000000000000000000111
1000000000000000000000000000000000000000000000000000000000000000000000000000000000000000000000000000111
1000000000000000000000000000000000000000000000000000000000000000000000000000000000000000000000000000111
1000111111111110000000000000000000000000111111111100000000000000000000000000001111111111110000000000111
1000100000000010000000000000000000000000100000001100000000000000000000000000001000000000010000000000111
1000100000000010000000000000000000000000100000001100000000000000000000000000001000000000010000000000111
1000100000000010000000000000000000000000100000001100000000000000000000000000001000000000010000000000111
1000100000000010000000000000000000000000100000001100000000000000000000000000001000000000010000000000111
1000100000000010000000000000000000000000100000001100000000000000000000000000001000000000010000000000111
10001000000000100000000000N0000000000000100000001100000000000000000000000000001000000000010000000000111
1000100000000010000000000000000000000000100000001100000000000000000000000000001000000000010000000000111
1000100000000010000000000000000000000000100000001100000000000000000000000000001000000000010000000000111
1000100000000010000000000000000000000000100000001100000000000000000000000000001000000000010000000000111
1000100000000010000000000000000000000000100000001100000000000000000000000000001000000000010000000000111
1000111111111110000000000000000000000000111111111100000000000000000000000000001111111111110000000000111
1000000000000000000000000000000000000000000000000000000000000000000000000000000000000000000000000000111
1000000000000000000000000000000000000000000000000000000000000000000000000000000000000000000000000000111
1000000000000000000000000000000000000000000000000000000000000000000000000000000000000000000000000000111
1000000000000000000000000000000000000000000000000000000000000000000000000000000000000000000000000000111
1000000000000000000000000000000000000000000000000000000000000000000000000000000000000000000000000000111
1111111111111111111111111111111111111111111111111111111111111111111111111111111111111111111111111111111
