NO ./path_to_the_north_texture
EA ./path_to_the_east_texture
SO ./path_to_the_north_texture
WE ./path_to_the_west_texture

C 255,255,255
F 0,255,0

1111111111111111111111111
1000000000110000000000001
101100000111000000N000001
1001000000000000000000001
1111111111111111111111111
