NO ./path_to_the_north_texture
EA ./path_to_the_east_texture
SO ./path_to_the_north_texture
WE ./path_to_the_west_texture

C 0,0,200
F 0,200,0

1111111111111111111111111
1000000000110000000000001
101100000111000000W000001
1001000000000000000000001
1111111111111111111111111111
