NO ./textures/test.xpm
SO ./textures/test.xpm
WE ./textures/test.xpm
EA ./textures/test.xpm

F 60,60,60
C 0,60,200

        11111111111111111111111111111111111111
        1E000000000000000000000000000000000001
1111111110000000000000000000000000000111111111
10000000000000000000000000000000000001
10000000000000000000000011111111111111
1000000000000000000000001
1000000000000000100000001
1000000000000000000000001
10000000000000000100000011111111111111
10000000000000001000000000000000000001
10000000000000000000000000000000000001
10000000000000000000000000000000000001
10000000000000000000000000000000000001
10000000000000000000000000000000000001
10000000000000000000000000000000000001
11100000000000000000000000000000000001
  111111111111111111111111111111111111
